paNamawippu	N_NN	B-NP	paNamawippu,N
nIkkam	N_NN	I-NP	nIkkam,N
kurYippitawwakka	JJ	B-NP	kurYippitam,N,wakka-ADJ,,,,
alYavil	N_NN	I-NP	alYavu,N,il-LOC
cAwakamAnYa	JJ	B-NP	cAwakam,N,AnYa-ADJ
pAwippE	N_NN	I-NP	pAwippu,N,E-ACC
koVtuwwulYlYawu	V_VM_VF	B-VGF	koVtu,V,PRESENT,sg,3,n,RP-PRP
-	RD_SYM	I-VGF	-,punc
mawwiya	JJ	B-NP	mawwiya,ADJ
aracu	N_NN	I-NP	aracu,N

paNamawippunIkkam	N_NN	B-NP	paNamawippunIkkam,unk
kurYippitawwakka	JJ	B-NP	kurYippitam,N,wakka-ADJ,,,,
alYavil	N_NN	I-NP	alYavu,N,il-LOC
cAwakamAnYa	JJ	B-NP	cAwakam,N,AnYa-ADJ
vilYEvukalYE	N_NN	I-NP	vilYEvu,N,E-ACC,pl
erYpatuwwiyulYlYawu	V_VM_VF	B-VGF	erYpatuwwu,V,PRESENT,sg,3,n,RP-PRP
eVnYa	CC_CCS	B-CCP	eVnYa,ADV,,,,,
mawwiya	JJ	B-NP	mawwiya,ADJ
aracu	N_NN	I-NP	aracu,N
kUrYiyulYlYawu	V_VM_VF	B-VGF	kUrYu,V,PRESENT,sg,3,n,RP-PRP
.	RD_PUNC	I-VGF	&dot;,punc

puwuteVlli	N_NNP	B-NP	puwuteVlli,N
kurYippAka	RB	B-RBP	kurYippu,N,Aka-ADV
wIviravAwa	RP_NEG	B-NEGP	wIviravAwa,ADJ
ceVyalpAtukalYil	N_NN	B-NP	ceVyalpAtu,N,il-LOC,pl
awanY	PR_PRP	B-NP	awanY,PN
wAkkam	N_NN	I-NP	wAkkam,N
cAwakamAka	RB	B-VGF	cAwakam,N,Aka-ADV
irukkirYawu	V_VM_VF	I-VGF	iru,V,PRESENT,sg,3,n,
eVnYrYu	CC_CCS	B-CCP	eVnYrYu,ADV,,,,,
mawwiya	JJ	B-NP	mawwiya,ADJ
ulYwurYE	N_NN	I-NP	ulYwurYE,N
iNE	N_NN	B-NP	iNE,N,,,,,
amEccar	N_NN	I-NP	amEccar,N
hanYsrAj	N_NNP	B-NP	hanYsrAj,N,,,,m
kafkArAm	N_NNP	I-NP	kafkArAm,N,,,,,
ahir	N_NN	I-NP	ahir,unk
makkalYavEyil	N_NN	I-NP	makkalYavE,N,il-LOC
koVtuwwa	V_VM_VNF_RP	B-VGNF	koVtu,V,PAST,,,,RP
eVlYYuwwupUrvamAnYa	JJ	B-NP	eVlYYuwwupUrvamAnYa,unk
pawilil	N_NN	I-NP	pawil,N,il-LOC
weVriviwwAr	V_VM_VF	B-VGF	weVrivi,V,PAST,sg,3,c
.	RD_PUNC	I-VGF	&dot;,punc

“	RD_SYM	B-NP	“,punc
mawwiya	JJ	I-NP	mawwiya,ADJ
pulanYAyvu	N_NN	I-NP	pulanYAyvu,N
amEppukalY	N_NN	B-NP	amEppu,N,,pl
kUrYiyulYlYapati	V_VM_VNF_RP_PSP	B-VGNF	kUrYiyulYlYapati,unk
rU.	N_NN	B-NP	rU,N
500	QT_QTC	I-NP	500,num
marYrYum	CC_CCD	B-CCP	marYrYum,CONJ
rU.	N_NN	B-NP	rU,N
1000	QT_QTC	I-NP	1000,num
AkiyavarYrYinY	N_NN	I-NP	AkiyavE,N,inY-GEN
paNa	N_NN	B-NP	paNam,N,a-ADJ
mawippu	N_NN	I-NP	mawippu,N
nIkkam	N_NN	I-NP	nIkkam,N
wIviravAwa	RP_NEG	B-NEGP	wIviravAwa,ADJ
ceVyalkalYinY	N_NN	B-NP	ceVyal,N,inY-GEN,pl
mIwu	PSP	B-BLK	mIwu,PSP
wAkkawwE	N_NN	B-NP	wAkkam,N,E-ACC
erYpatuwwiyulYlYawu	V_VM_VF	B-VGF	erYpatuwwu,V,PRESENT,sg,3,n,RP-PRP
”	RD_SYM	I-VGF	”,punc
eVnYrYAr	V_VM_VF	I-VGF	eVnY,V,PAST,sg,3,c
amEccar	N_NN	B-NP	amEccar,N
.	RD_PUNC	I-NP	&dot;,punc

cattavirowamAka	RB	B-VGNF	cattavirowam,N,Aka-ADV
pawukki	V_VM_VNF_VBN	I-VGNF	pawukku,V,,,,,VBP
vEkkappattirunwa	V_VM_VNF_RP	I-VGNF	vEkkappatu,V,PAST,,,,RP
peVrumalYavilAnYa	JJ	B-NP	peVrumalYavilAnYa,ADJ
paNam	N_NN	I-NP	paNam,N
payanYarYrYu	RP_NEG	B-NEGP	payanYarYrYu,ADV,,,,,
poyvittawu	V_VM_VF	B-VGF	poyvitu,V,PAST,sg,3,n,RP-PRP
eVnYrYu	CC_CCS	B-CCP	eVnYrYu,ADV,,,,,
kUrYinYAr	V_VM_VF	B-VGF	kUrYu,V,PAST,sg,3,c
amEccar	N_NN	B-NP	amEccar,N
.	RD_PUNC	I-NP	&dot;,punc

melum	CC_CCD	B-CCP	melum,ADV
pAkiswAnY	N_NNP	B-NP	pAkiswAnY,N
accatiwwu	V_VM_VNF_VBN	B-VGNF	accati,V,,,,,VBP
pulYYakkawwil	N_NN	B-NP	pulYYakkam,N,il-LOC
vitta	V_VM_VNF_RP	B-VGNF	vitu,V,PAST,,,,RP
uyarwara	N_NN	B-NP	uyarwaram,N,a-ADJ
poli	N_NN	I-NP	poli,N
rUpAy	N_NN	I-NP	rUpAy,N,,,,,
nottukalYEyum	N_NN	I-NP	nottu,N,E-ACC,pl
paNamawippunIkkam	N_NN	B-NP	paNamawippunIkkam,unk
kulEwwu	V_VM_VNF_VBN	B-VGF	kulE,V,,,,,VBP
vittawu	V_VM_VF	I-VGF	vitu,V,PAST,sg,3,n,RP-PRP
.	RD_PUNC	I-VGF	&dot;,punc

awwutanY	PR_PRP	B-NP	awwutanY,ADV,,,,,
havAlA	N_NNP	B-NP	havAlA,N,,,,,
ceVyalpAtukalYEyum	N_NN	I-NP	ceVyalpAtu,N,E-ACC,pl
katumEyAka	RB	B-VGF	katumE,N,Aka-ADV,,,,
pAwikkappattulYlYawu	V_VM_VF	I-VGF	pAwikkappatu,V,PRESENT,sg,3,n,RP-PRP
eVnYrYAr	V_VM_VF	I-VGF	eVnY,V,PAST,sg,3,c
ahir	N_NN	B-NP	ahir,unk
.	RD_PUNC	I-NP	&dot;,punc

