paNamawippu	N_NN
nIkkam	N_NN
kurYippitawwakka	JJ
alYavil	N_NN
cAwakamAnYa	JJ
pAwippE	N_NN
koVtuwwulYlYawu	V_VM_VF
-	RD_SYM
mawwiya	JJ
aracu	N_NN

paNamawippunIkkam	N_NN
kurYippitawwakka	JJ
alYavil	N_NN
cAwakamAnYa	JJ
vilYEvukalYE	N_NN
erYpatuwwiyulYlYawu	V_VM_VF
eVnYa	CC_CCS
mawwiya	JJ
aracu	N_NN
kUrYiyulYlYawu	V_VM_VF
.	RD_PUNC

jUlE	N_NNP
25	QT_QTC
,	RD_PUNC
2017	QT_QTC
,	RD_PUNC
07:29	QT_QTC
PM	QT_QTC

puwuteVlli	N_NNP
kurYippAka	RB
wIviravAwa	RP_NEG
ceVyalpAtukalYil	N_NN
awanY	PR_PRP
wAkkam	N_NN
cAwakamAka	RB
irukkirYawu	V_VM_VF
eVnYrYu	CC_CCS
mawwiya	JJ
ulYwurYE	N_NN
iNE	N_NN
amEccar	N_NN
hanYsrAj	N_NNP
kafkArAm	N_NNP
ahir	N_NN
makkalYavEyil	N_NN
koVtuwwa	V_VM_VNF_RP
eVlYYuwwupUrvamAnYa	JJ
pawilil	N_NN
weVriviwwAr	V_VM_VF
.	RD_PUNC

“	RD_SYM
mawwiya	JJ
pulanYAyvu	N_NN
amEppukalY	N_NN
kUrYiyulYlYapati	V_VM_VNF_RP_PSP
rU.	N_NN
500	QT_QTC
marYrYum	CC_CCD
rU.	N_NN
1000	QT_QTC
AkiyavarYrYinY	N_NN
paNa	N_NN
mawippu	N_NN
nIkkam	N_NN
wIviravAwa	RP_NEG
ceVyalkalYinY	N_NN
mIwu	PSP
wAkkawwE	N_NN
erYpatuwwiyulYlYawu	V_VM_VF
”	RD_SYM
eVnYrYAr	V_VM_VF
amEccar	N_NN
.	RD_PUNC

cattavirowamAka	RB
pawukki	V_VM_VNF_VBN
vEkkappattirunwa	V_VM_VNF_RP
peVrumalYavilAnYa	JJ
paNam	N_NN
payanYarYrYu	RP_NEG
poyvittawu	V_VM_VF
eVnYrYu	CC_CCS
kUrYinYAr	V_VM_VF
amEccar	N_NN
.	RD_PUNC

melum	CC_CCD
pAkiswAnY	N_NNP
accatiwwu	V_VM_VNF_VBN
pulYYakkawwil	N_NN
vitta	V_VM_VNF_RP
uyarwara	N_NN
poli	N_NN
rUpAy	N_NN
nottukalYEyum	N_NN
paNamawippunIkkam	N_NN
kulEwwu	V_VM_VNF_VBN
vittawu	V_VM_VF
.	RD_PUNC

awwutanY	PR_PRP
havAlA	N_NNP
ceVyalpAtukalYEyum	N_NN
katumEyAka	RB
pAwikkappattulYlYawu	V_VM_VF
eVnYrYAr	V_VM_VF
ahir	N_NN
.	RD_PUNC

