kupwap	JJ	B-NP	kupwam,N,a-ADJ
peraracu	N_NN	I-NP	peraracu,N,,,,m
(	RD_SYM	B-NP	(,punc
Atcik	N_NN	I-NP	Atci,N
kAlam	N_NN	I-NP	kAlam,N
ki	RD_ECH	B-VGNF	ki,unk
pi	RD_ECH	I-VGNF	pi,N
320	RD_ECH	B-NP	320,num
–	RD_SYM	I-NP	–,punc
550	QT_QTC	I-NP	550,num
)	RD_SYM	I-NP	),punc
inwiyaw	N_NNP	B-NP	inwiya,ADJ
wuNEkkaNtawwinY	N_NN	I-NP	wuNEkkaNtam,N,inY-GEN
peVrum	JJ	B-NP	peVrum,ADJ
pakuwikalYE	N_NN	I-NP	pakuwi,N,E-ACC,pl
ANta	V_VM_VNF_RP	B-VGNF	AlY,V,PAST,,,,RP
peraracukalYil	N_NN	B-NP	peraracu,N,il-LOC,pl,,m
oVnYrYAka	RB	B-VGF	oVnYrYu,N,Aka-ADV
vilYafkiyawu	V_VM_VF	I-VGF	vilYafku,V,PAST,sg,3,n
.	RD_PUNC	I-VGF	&dot;,punc

kupwap	JJ	B-NP	kupwam,N,a-ADJ
peraracE	N_NN	I-NP	peraracu,N,E-ACC,,,m
nirYuviyavar	V_VM_VNF_RP_PRP	B-VGNF	nirYuvu,V,PAST
srIkupwar	N_NNP	B-NP	srIkupwar,unk
AvAr	V_VM_VF	B-VGF	Aku,V,FUTURE,sg,3,c
.	RD_PUNC	I-VGF	&dot;,punc

ki	N_NNP	B-NP	ki,unk
pi	N_NNP	I-NP	pi,N
320	QT_QTC	B-NP	320,num
muwal	PSP	B-BLK	muwal,ADJ
550	QT_QTC	B-NP	550,num
varE	PSP	B-BLK	varE,PSP
,	RD_PUNC	I-BLK	&comma;,punc
kupwar	N_NNP	B-NP	kupwar,N
eVnYum	CC_CCS	B-CCP	eVnY,PN
araca	N_NN	B-NP	araca,ADJ
marapinYarAl	N_NN	I-NP	marapinYar,N,Al-INS
AlYappatta	V_VM_VNF_RP	B-VGNF	AlY,V,PAST,,,,RP
ipperaracu	N_NN	B-NP	peraracu,N,,,,m
awanY	PR_PRP	B-NP	awanY,PN
uccakkattawwil	N_NN	I-NP	uccakkattam,N,il-LOC
,	RD_PUNC	B-NP	&comma;,punc
akkAla	N_NN	B-NP	kAlam,N,a-ADJ
vata	N_NNP	B-NP	vata,ADJ
inwiyAvinY	N_NNP	I-NP	inwiyA,N,inY-GEN
peVrum	JJ	B-NP	peVrum,ADJ
pakuwiyE	N_NN	I-NP	pakuwi,N,E-ACC
ulYlYatakki	V_VM_VNF_VBN	B-VGF	ulYlYatakku,V,,,,,VBP
irunwawu	V_VM_VF	I-VGF	iru,V,PAST,sg,3,n,RP-PRP
.	RD_PUNC	I-VGF	&dot;,punc

ipperaracinY	N_NN	B-NP	peraracu,N,inY-GEN,,,m
pakuwikalYAka	RB	B-RBP	pakuwi,N,,pl
inYrYEya	JJ	B-NP	inYrYEya,ADJ
pAkiswAnY	N_NNP	I-NP	pAkiswAnY,N
,	RD_PUNC	I-NP	&comma;,punc
inwiyA	N_NNP	B-NP	inwiyA,N
,	RD_PUNC	I-NP	&comma;,punc
vafkAlYawecam	N_NNP	B-NP	vafkAlYawecam,N
Akiya	JJ	B-NP	Akiya,ADJ
nAtukalY	N_NN	I-NP	nAtu,N,,pl
amEnwirunwanYa	V_VM_VF	B-VGF	amEnwiru,V,PAST,pl,3,c
.	RD_PUNC	I-VGF	&dot;,punc

arYiviyal	N_NN	B-NP	arYiviyal,N
,	RD_PUNC	I-NP	&comma;,punc
kaNiwam	N_NN	B-NP	kaNiwam,N
,	RD_PUNC	I-NP	&comma;,punc
vAnYiyal	N_NN	B-NP	vAnYiyal,N
,	RD_PUNC	I-NP	&comma;,punc
camayam	N_NN	B-NP	camayam,N
,	RD_PUNC	I-NP	&comma;,punc
inwiya	N_NNP	B-NP	inwiya,ADJ
wawwuvam	N_NN	I-NP	wawwuvam,N
Akiya	JJ	B-NP	Akiya,ADJ
wurYEkalYil	N_NN	I-NP	wurYE,N,il-LOC,pl
cirYanwu	V_VM_VNF_VBN	B-VGNF	cirYa,V,,,,,VBP
vilYafkiyawAl	V_VM_VNF_COND	I-VGNF	vilYafku,V,PAST,,,,COND
,	RD_PUNC	I-VGNF	&comma;,punc
kupwap	JJ	B-NP	kupwam,N,a-ADJ
peracinY	N_NN	I-NP	peracinY,unk
kAlam	N_NN	I-NP	kAlam,N
inwiyAvinY	N_NNP	B-NP	inwiyA,N,inY-GEN
poVrYkAlam	N_NN	I-NP	poVrYkAlam,N
eVnYak	CC_CCS	B-CCP	eVnYa,ADV
kurYippitappatuvawu	V_VM_VNF_RP_PRP	B-VGF	kurYippitu,V,FUTURE,sg,3,n
uNtu	V_VM_VF	I-VGF	uNtu,V
.	RD_PUNC	I-VGF	&dot;,punc

kupwarkalYinY	N_NNP	B-NP	kupwar,N,inY-GEN,pl
Atciyil	N_NN	I-NP	Atci,N,il-LOC
erYpattirunwa	V_VM_VNF_RP	B-VGNF	erYpattiru,V,PAST,,,,RP
amEwiyum	N_NN	B-NP	amEwi,N
,	RD_PUNC	I-NP	&comma;,punc
valYamum	N_NN	B-NP	valYam,N,,pl
arYiviyal	N_NN	I-NP	arYiviyal,N
marYrYum	CC_CCD	B-CCP	marYrYum,CONJ
kalEw	N_NN	B-NP	kalE,N
wurYEkalYil	N_NN	I-NP	wurYE,N,il-LOC,pl
valYarcci	N_NN	B-NP	valYarcci,N
erYpatuvawE	V_VM_VNF_RP_PRP	B-VGF	erYpatu,V,FUTURE,,,,RP-PRP
.	RD_PUNC	I-VGF	&dot;,punc

