innilEyil	N_NN	B-NP	innilE,N,il-LOC
,	RD_PUNC	B-NP	&comma;,punc
inwa	DM_DMR	B-NP	inwa,ADJ
valYYakku	N_NN	I-NP	valYYakku,N
inYrYu	N_NN	B-NP	inYrYu,N
mINtum	RB	B-RBP	mINtum,ADV
vicAraNEkku	N_NN	B-NP	vicAraNE,N,kku-DAT
vanwa	V_VM_VNF_RP	B-VGNF	vA,V,PAST,,,,RP
powu	PSP	B-BLK	powu,PSP
,	RD_PUNC	I-BLK	&comma;,punc
maruwwuvap	N_NN	B-NP	maruwwuvam,N,a-ADJ
patippil	N_NN	I-NP	patippu,N,il-LOC
,	RD_PUNC	B-NP	&comma;,punc
85	QT_QTC	B-NP	85,num
cawavIwa	N_NN	I-NP	cawavIwam,N,a-ADJ
ulY	N_NN	I-NP	ulY,V
oVwukkItu	N_NN	B-NP	oVwukkItu,N
alYiwwu	V_VM_VNF_VBN	B-VGNF	alYi,V,,,,,VBP
,	RD_PUNC	I-VGNF	&comma;,punc
wamilYYaka	N_NNP	B-NP	wamilYYaka,ADJ
aracu	N_NN	I-NP	aracu,N
pirYappiwwa	V_VM_VNF_RP	B-VGNF	pirYappi,V,PAST,,,,RP
aracANEyE	N_NN	B-NP	aracANE,N,E-ACC
rawwu	N_NN	B-NP	rawwu,N
ceVywu	V_VM_VNF_VBN	B-VGF	ceVy,V,,,,,VBP
uwwaravittAr	V_VM_VF	I-VGF	uwwaravitu,V,PAST,sg,3,c
.	RD_PUNC	I-VGF	&dot;,punc

