kupwap	JJ
peraracu	N_NN
(	RD_SYM
Atcik	N_NN
kAlam	N_NN
ki	RD_ECH
pi	RD_ECH
320	RD_ECH
â€“	RD_SYM
550	QT_QTC
)	RD_SYM
inwiyaw	N_NNP
wuNEkkaNtawwinY	N_NN
peVrum	JJ
pakuwikalYE	N_NN
ANta	V_VM_VNF_RP
peraracukalYil	N_NN
oVnYrYAka	RB
vilYafkiyawu	V_VM_VF
.	RD_PUNC

kupwap	JJ
peraracE	N_NN
nirYuviyavar	V_VM_VNF_RP_PRP
srIkupwar	N_NNP
AvAr	V_VM_VF
.	RD_PUNC

ki	N_NNP
pi	N_NNP
320	QT_QTC
muwal	PSP
550	QT_QTC
varE	PSP
,	RD_PUNC
kupwar	N_NNP
eVnYum	CC_CCS
araca	N_NN
marapinYarAl	N_NN
AlYappatta	V_VM_VNF_RP
ipperaracu	N_NN
awanY	PR_PRP
uccakkattawwil	N_NN
,	RD_PUNC
akkAla	N_NN
vata	N_NNP
inwiyAvinY	N_NNP
peVrum	JJ
pakuwiyE	N_NN
ulYlYatakki	V_VM_VNF_VBN
irunwawu	V_VM_VF
.	RD_PUNC

ipperaracinY	N_NN
pakuwikalYAka	RB
inYrYEya	JJ
pAkiswAnY	N_NNP
,	RD_PUNC
inwiyA	N_NNP
,	RD_PUNC
vafkAlYawecam	N_NNP
Akiya	JJ
nAtukalY	N_NN
amEnwirunwanYa	V_VM_VF
.	RD_PUNC

arYiviyal	N_NN
,	RD_PUNC
kaNiwam	N_NN
,	RD_PUNC
vAnYiyal	N_NN
,	RD_PUNC
camayam	N_NN
,	RD_PUNC
inwiya	N_NNP
wawwuvam	N_NN
Akiya	JJ
wurYEkalYil	N_NN
cirYanwu	V_VM_VNF_VBN
vilYafkiyawAl	V_VM_VNF_COND
,	RD_PUNC
kupwap	JJ
peracinY	N_NN
kAlam	N_NN
inwiyAvinY	N_NNP
poVrYkAlam	N_NN
eVnYak	CC_CCS
kurYippitappatuvawu	V_VM_VNF_RP_PRP
uNtu	V_VM_VF
.	RD_PUNC

kupwarkalYinY	N_NNP
Atciyil	N_NN
erYpattirunwa	V_VM_VNF_RP
amEwiyum	N_NN
,	RD_PUNC
valYamum	N_NN
arYiviyal	N_NN
marYrYum	CC_CCD
kalEw	N_NN
wurYEkalYil	N_NN
valYarcci	N_NN
erYpatuvawE	V_VM_VNF_RP_PRP
.	RD_PUNC

