kupwap	JJ	kupwam,N,a-ADJ,,,,|kupwanY,N,a-ADJ,,,m,|kupwar,N,a-ADJ,,,,|kupwA,N,a-ADJ
peraracu	N_NN	peraracu,N,,,,m
(	RD_SYM	(,punc
Atcik	N_NN	Atci,N
kAlam	N_NN	kAlam,N
ki	RD_ECH	ki,unk
pi	RD_ECH	pi,N
320	RD_ECH	320,num
–	RD_SYM	–,punc
550	QT_QTC	550,num
)	RD_SYM	),punc
inwiyaw	N_NNP	inwiya,ADJ
wuNEkkaNtawwinY	N_NN	wuNEkkaNtam,N,inY-GEN
peVrum	JJ	peVrum,ADJ
pakuwikalYE	N_NN	pakuwi,N,E-ACC,pl
ANta	V_VM_VNF_RP	AlY,V,PAST,,,,RP
peraracukalYil	N_NN	peraracu,N,il-LOC,pl,,m
oVnYrYAka	RB	oVnYrYAka,ADV,,,,,|oVnYrYu,N,Aka-ADV
vilYafkiyawu	V_VM_VF	vilYafku,V,PAST,sg,3,n,|vilYafku,V,PAST,sg,3,n,RP-PRP
.	RD_PUNC	&dot;,punc

kupwap	JJ	kupwam,N,a-ADJ,,,,|kupwanY,N,a-ADJ,,,m,|kupwar,N,a-ADJ,,,,|kupwA,N,a-ADJ
peraracE	N_NN	peraracu,N,E-ACC,,,m
nirYuviyavar	V_VM_VNF_RP_PRP	nirYuvu,V,PAST
srIkupwar	N_NNP	srIkupwar,unk
AvAr	V_VM_VF	Aku,V,FUTURE,sg,3,c
.	RD_PUNC	&dot;,punc

ki	N_NNP	ki,unk
pi	N_NNP	pi,N
320	QT_QTC	320,num
muwal	PSP	muwal,ADJ,,,,,|muwal,N
550	QT_QTC	550,num
varE	PSP	varE,PSP,,,,,|varE,V
,	RD_PUNC	&comma;,punc
kupwar	N_NNP	kupwar,N
eVnYum	CC_CCS	eVnY,PN,,,,,|eVnY,V,FUTURE,sg,3,n
araca	N_NN	araca,ADJ
marapinYarAl	N_NN	marapinYar,N,Al-INS
AlYappatta	V_VM_VNF_RP	AlY,V,PAST,,,,RP
ipperaracu	N_NN	peraracu,N,,,,m
awanY	PR_PRP	awanY,PN
uccakkattawwil	N_NN	uccakkattam,N,il-LOC
,	RD_PUNC	&comma;,punc
akkAla	N_NN	kAlam,N,a-ADJ,,,,|kAlanY,N,a-ADJ,,,,|kAlar,N,a-ADJ
vata	N_NNP	vata,ADJ
inwiyAvinY	N_NNP	inwiyA,N,inY-GEN
peVrum	JJ	peVrum,ADJ
pakuwiyE	N_NN	pakuwi,N,E-ACC
ulYlYatakki	V_VM_VNF_VBN	ulYlYatakki,N,,,,,|ulYlYatakku,V,,,,,VBP
irunwawu	V_VM_VF	iru,V,PAST,sg,3,n,RP-PRP|iru,V,PAST,sg,3,n
.	RD_PUNC	&dot;,punc

ipperaracinY	N_NN	peraracu,N,inY-GEN,,,m
pakuwikalYAka	RB	pakuwi,N,,pl
inYrYEya	JJ	inYrYEya,ADJ
pAkiswAnY	N_NNP	pAkiswAnY,N
,	RD_PUNC	&comma;,punc
inwiyA	N_NNP	inwiyA,N,,,,,|inwi,N
,	RD_PUNC	&comma;,punc
vafkAlYawecam	N_NNP	vafkAlYawecam,N
Akiya	JJ	Akiya,ADJ,,,,,|Aku,V,PAST,,,,RP
nAtukalY	N_NN	nAtu,N,,pl
amEnwirunwanYa	V_VM_VF	amEnwiru,V,PAST,pl,3,c,|amE,V,PAST,pl,3,c,|amEnwiru,V,PAST,pl,3,n,|amE,V,PAST,pl,3,n
.	RD_PUNC	&dot;,punc

arYiviyal	N_NN	arYiviyal,N
,	RD_PUNC	&comma;,punc
kaNiwam	N_NN	kaNiwam,N
,	RD_PUNC	&comma;,punc
vAnYiyal	N_NN	vAnYiyal,N
,	RD_PUNC	&comma;,punc
camayam	N_NN	camayam,N
,	RD_PUNC	&comma;,punc
inwiya	N_NNP	inwiya,ADJ
wawwuvam	N_NN	wawwuvam,N
Akiya	JJ	Akiya,ADJ,,,,,|Aku,V,PAST,,,,RP
wurYEkalYil	N_NN	wurYE,N,il-LOC,pl
cirYanwu	V_VM_VNF_VBN	cirYa,V,,,,,VBP
vilYafkiyawAl	V_VM_VNF_COND	vilYafku,V,PAST,,,,COND
,	RD_PUNC	&comma;,punc
kupwap	JJ	kupwam,N,a-ADJ,,,,|kupwanY,N,a-ADJ,,,m,|kupwar,N,a-ADJ,,,,|kupwA,N,a-ADJ
peracinY	N_NN	peracinY,unk
kAlam	N_NN	kAlam,N
inwiyAvinY	N_NNP	inwiyA,N,inY-GEN
poVrYkAlam	N_NN	poVrYkAlam,N
eVnYak	CC_CCS	eVnYa,ADV,,,,,|eVnY,V,,,,,INF
kurYippitappatuvawu	V_VM_VNF_RP_PRP	kurYippitu,V,FUTURE,sg,3,n
uNtu	V_VM_VF	uNtu,V,,,,,|uN,V,,,,,VBP
.	RD_PUNC	&dot;,punc

kupwarkalYinY	N_NNP	kupwar,N,inY-GEN,pl
Atciyil	N_NN	Atci,N,il-LOC
erYpattirunwa	V_VM_VNF_RP	erYpattiru,V,PAST,,,,RP|erYpatu,V,PAST,,,,RP
amEwiyum	N_NN	amEwi,N
,	RD_PUNC	&comma;,punc
valYamum	N_NN	valYam,N,,pl
arYiviyal	N_NN	arYiviyal,N
marYrYum	CC_CCD	marYrYum,CONJ
kalEw	N_NN	kalE,N,,,,,|kalE,V
wurYEkalYil	N_NN	wurYE,N,il-LOC,pl
valYarcci	N_NN	valYarcci,N
erYpatuvawE	V_VM_VNF_RP_PRP	erYpatu,V,FUTURE,sg,3,n,|erYpatu,V,FUTURE,,,,RP-PRP
.	RD_PUNC	&dot;,punc

