paNamawippu	N_NN	paNamawippu,N
nIkkam	N_NN	nIkkam,N
kurYippitawwakka	JJ	kurYippitawwakka,ADJ5,,,,,|kurYippitam,N,wakka-ADJ,,,,|kurYippitu,V
alYavil	N_NN	alYavu,N,il-LOC
cAwakamAnYa	JJ	cAwakam,N,AnYa-ADJ
pAwippE	N_NN	pAwippu,N,E-ACC
koVtuwwulYlYawu	V_VM_VF	koVtu,V,PRESENT,sg,3,n,RP-PRP|koVtu,V,PRESENT,sg,3,n
-	RD_SYM	-,punc
mawwiya	JJ	mawwiya,ADJ
aracu	N_NN	aracu,N

paNamawippunIkkam	N_NN	paNamawippunIkkam,unk
kurYippitawwakka	JJ	kurYippitawwakka,ADJ5,,,,,|kurYippitam,N,wakka-ADJ,,,,|kurYippitu,V
alYavil	N_NN	alYavu,N,il-LOC
cAwakamAnYa	JJ	cAwakam,N,AnYa-ADJ
vilYEvukalYE	N_NN	vilYEvu,N,E-ACC,pl
erYpatuwwiyulYlYawu	V_VM_VF	erYpatuwwu,V,PRESENT,sg,3,n,RP-PRP|erYpatuwwu,V,PRESENT,sg,3,n
eVnYa	CC_CCS	eVnYa,ADV,,,,,|eVnY,V,,,,,INF
mawwiya	JJ	mawwiya,ADJ
aracu	N_NN	aracu,N
kUrYiyulYlYawu	V_VM_VF	kUrYu,V,PRESENT,sg,3,n,RP-PRP|kUrYu,V,PRESENT,sg,3,n
.	RD_PUNC	&dot;,punc

jUlE	N_NNP	jUlE,N,,,,,|jUl,N,E-ACC
25	QT_QTC	25,num
,	RD_PUNC	&comma;,punc
2017	QT_QTC	2017,num
,	RD_PUNC	&comma;,punc
07:29	QT_QTC	07:29,unk
PM	QT_QTC	PM,unk

puwuteVlli	N_NNP	puwuteVlli,N
kurYippAka	RB	kurYippAka,ADV,,,,,|kurYippu,N,Aka-ADV
wIviravAwa	RP_NEG	wIviravAwa,ADJ
ceVyalpAtukalYil	N_NN	ceVyalpAtu,N,il-LOC,pl
awanY	PR_PRP	awanY,PN
wAkkam	N_NN	wAkkam,N
cAwakamAka	RB	cAwakam,N,Aka-ADV
irukkirYawu	V_VM_VF	iru,V,PRESENT,sg,3,n,|iru,V,PRESENT,sg,3,n,RP-PRP|iru,V,PRESENT,,,,RP-PRP
eVnYrYu	CC_CCS	eVnYrYu,ADV,,,,,|eVnYrYu,UT
mawwiya	JJ	mawwiya,ADJ
ulYwurYE	N_NN	ulYwurYE,N
iNE	N_NN	iNE,N,,,,,|iNE,V
amEccar	N_NN	amEccar,N
hanYsrAj	N_NNP	hanYsrAj,N,,,,m
kafkArAm	N_NNP	kafkArAm,N,,,,,|kafkAru,N
ahir	N_NN	ahir,unk
makkalYavEyil	N_NN	makkalYavE,N,il-LOC
koVtuwwa	V_VM_VNF_RP	koVtu,V,PAST,,,,RP
eVlYYuwwupUrvamAnYa	JJ	eVlYYuwwupUrvamAnYa,unk
pawilil	N_NN	pawil,N,il-LOC
weVriviwwAr	V_VM_VF	weVrivi,V,PAST,sg,3,c
.	RD_PUNC	&dot;,punc

“	RD_SYM	“,punc
mawwiya	JJ	mawwiya,ADJ
pulanYAyvu	N_NN	pulanYAyvu,N
amEppukalY	N_NN	amEppu,N,,pl
kUrYiyulYlYapati	V_VM_VNF_RP_PSP	kUrYiyulYlYapati,unk
rU.	N_NN	rU,N
500	QT_QTC	500,num
marYrYum	CC_CCD	marYrYum,CONJ
rU.	N_NN	rU,N
1000	QT_QTC	1000,num
AkiyavarYrYinY	N_NN	AkiyavE,N,inY-GEN
paNa	N_NN	paNam,N,a-ADJ
mawippu	N_NN	mawippu,N
nIkkam	N_NN	nIkkam,N
wIviravAwa	RP_NEG	wIviravAwa,ADJ
ceVyalkalYinY	N_NN	ceVyal,N,inY-GEN,pl
mIwu	PSP	mIwu,PSP
wAkkawwE	N_NN	wAkkam,N,E-ACC
erYpatuwwiyulYlYawu	V_VM_VF	erYpatuwwu,V,PRESENT,sg,3,n,RP-PRP|erYpatuwwu,V,PRESENT,sg,3,n
”	RD_SYM	”,punc
eVnYrYAr	V_VM_VF	eVnY,V,PAST,sg,3,c
amEccar	N_NN	amEccar,N
.	RD_PUNC	&dot;,punc

cattavirowamAka	RB	cattavirowam,N,Aka-ADV
pawukki	V_VM_VNF_VBN	pawukku,V,,,,,VBP
vEkkappattirunwa	V_VM_VNF_RP	vEkkappatu,V,PAST,,,,RP|vE,V,PAST,,,,RP
peVrumalYavilAnYa	JJ	peVrumalYavilAnYa,ADJ
paNam	N_NN	paNam,N
payanYarYrYu	RP_NEG	payanYarYrYu,ADV,,,,,|payanY,N
poyvittawu	V_VM_VF	poyvitu,V,PAST,sg,3,n,RP-PRP|poyvitu,V,PAST,sg,3,n
eVnYrYu	CC_CCS	eVnYrYu,ADV,,,,,|eVnYrYu,UT
kUrYinYAr	V_VM_VF	kUrYu,V,PAST,sg,3,c
amEccar	N_NN	amEccar,N
.	RD_PUNC	&dot;,punc

melum	CC_CCD	melum,ADV
pAkiswAnY	N_NNP	pAkiswAnY,N
accatiwwu	V_VM_VNF_VBN	accati,V,,,,,VBP
pulYYakkawwil	N_NN	pulYYakkam,N,il-LOC
vitta	V_VM_VNF_RP	vitu,V,PAST,,,,RP
uyarwara	N_NN	uyarwaram,N,a-ADJ
poli	N_NN	poli,N
rUpAy	N_NN	rUpAy,N,,,,,|rUp,N,Ay-ADV
nottukalYEyum	N_NN	nottu,N,E-ACC,pl
paNamawippunIkkam	N_NN	paNamawippunIkkam,unk
kulEwwu	V_VM_VNF_VBN	kulE,V,,,,,VBP
vittawu	V_VM_VF	vitu,V,PAST,sg,3,n,RP-PRP|vitu,V,PAST,sg,3,n
.	RD_PUNC	&dot;,punc

awwutanY	PR_PRP	awwutanY,ADV,,,,,|awwu,N,utanY-SOC
havAlA	N_NNP	havAlA,N,,,,,|havAl,N,,,,,|hav,N,Al-INS
ceVyalpAtukalYEyum	N_NN	ceVyalpAtu,N,E-ACC,pl
katumEyAka	RB	katumE,N,Aka-ADV,,,,|katumEyAku,V,,,,,INF
pAwikkappattulYlYawu	V_VM_VF	pAwikkappatu,V,PRESENT,sg,3,n,RP-PRP|pAwi,V,PRESENT,sg,3,n,RP-PRP|pAwikkappatu,V,PRESENT,sg,3,n,|pAwi,V,PRESENT,sg,3,n,|pAwi,V,PRESENT,,,,RP-PRP
eVnYrYAr	V_VM_VF	eVnY,V,PAST,sg,3,c
ahir	N_NN	ahir,unk
.	RD_PUNC	&dot;,punc

